S.##.....T#G
#T##..#.#.#.
#.###E#.#.#.
#..E..#T#.#E
###T#####...